6 11
7 5 4 0 6 5 4 2 5 0 2
1 4 4 0 2 5 0 0 0 2 3
1 2 5 4 0 4 2 1 0 2 3
7 1 0 4 0 4 2 1 0 0 6
5 0 2 7 3 1 0 4 0 0 6
5 0 4 4 2 5 4 6 5 0 6
